111111111111111111111111111111111111111
101100000001100000000001100000000000001
101100111001100111111001100111111000001
100001111101100111111001101111111001101
100001101101100001100001101100000001101
111111101101111001100111101100111111101
111111000001111001100111001101111111101
101100000001100001100000001101100001101
101100111111100111111111111101111001101
100001111111000111111111111100111100001
100001100000000000001100001100001100001
100111111111111111001100001111001100111
101111111111111111001101100111101100111
101100000001100000001101100001101100001
101100111001111000111101111001101111001
101100111100111100111001111001100111101
1011000011000011000000011000011000F1101
101111001111001111111001111111100001111
100111001111101111111101111111101100111
1000000011011011000011S1100001101100001
111111111101101111001101100001111100001
111111111001100111101101101100111101101
100000000001100001101101101100001101101
111000111111111001101101101111001111101
111001111111111101100001100111100111001
100001100000001101100001100001100000001
100001100111001101100111111001111111001
101101101111100001100111111001111111101
101101101101100001100001100001100001101
101101101101111111111001100111100001111
101101100001111111111001101111001100111
101101100001100001100001101100001100001
101111111001100001111001101100111111001
100111111101101100111101100001111111001
100000001101101100001101100001100000001
100000111101101111001111111111100111001
101100111000001111000111111111001111001
101100000000001100000000000000001100001
111111111111111111111111111111111111111