1111111111111111111111111
1100000000000000100000111
10S1101101111111101110111
1101101101111000000000111
1101111100111011111111111
1101111110000000000111111
1101101110111110111111111
1101101110111000000000111
1101101110111011111110111
1000000000111000000010001
1011101111111111111011101
1011100000000000000000101
1011111011111101111111101
1000000010000000000110001
1111111010111111110110111
1111100000111111110110111
1111101110100000000110011
1111101110101101111111011
1111001110101000110001011
1111011110101010000101001
1000000010101011111101101
1111011110001000001101101
1111011110101111101100001
100000001F100000001111111
1111111111111111111111111
