111111111111111111111111111111111111111
101100000000000000001100000000000000001
101100111111111111001111111111000111111
101100111111111111100111111111100111111
101100000001100001100000000001100000001
101100111001100111111111111001111111001
101100111101100111111111111101111111101
101100001101100000001100001101100001101
101111111101100000001111001101100001101
100111111001101101101111001100001100001
1000S0000001101101101100001100001100001
111111111111111101101100111111111111001
111111111111111001100001111111111111101
100001100000000001100001100000000001101
111001100000111111111001100111000111101
111001101100111111111001101111100111001
100001101100001100000001101101100000001
100111101111001111000111101101111111111
100111100111100111101111001100111111111
100001100001100001101100001100001100001
100001111001111001111100111100001100001
101100111100111101111001111101100001101
1011000011000F1101100001101101100001101
101100001111001101100111101101111111101
101101101111101100001111001101111111101
101101101101101100001100001101100001101
101101101101101111111111001101100111101
101101100001100111111111100000001111001
101101100001100001100001100000001100001
111101111111111001100001100111111100111
111001111111111001101101101111111100111
100001100000000001101101101100001100001
100001100111111111101101111100001100001
101101100111111111001100111001101101101
101101100001100000001100000001101101101
101111111001111000111111111111101111101
100111111000111001111111111111000111001
100000000000000001100000000000000000001
111111111111111111111111111111111111111