111111111000000000000000001111
10000000001111111111111110S001
101111111011111110000111111101
101000001011111110110000011101
101011101011100000110111111101
101010001011101111110111111101
101011111011101111110111111101
101010000011101111110111100001
101010111111101111110000001111
101010000000001111111111101011
100011111111000000111111101011
101111111111101110111111100011
10100000000F101110000011111011
101011011111101110111011111011
101011001110001110011011111011
101011101110111111011011111011
100011101110111111011000111011
101111101110000000011110000011
100000101111111111111110111111
111110101101111111111110000011
110000101101111111111111111011
110111100001111111111111111011
110111111101111100000000000011
110111111100000001111011011111
110000001111011101111011011111
111111101111011101111011011111
111111100000011101111011000011
111111111111011100000011011011
100000000000011111111111111011
111111111111111111111111111111
