S0011111111111111111
11000001111000001111
11111101111011100111
11110000000011110011
11110111011111111001
11000111011111111111
10011111000011111111
11111111111011111111
11000000000000011111
11111111111111000001
11111111111111111101
11111100000000000001
11111101111111111111
11111100001111111111
11111111101111111111
11100000000000011111
11101111111111011111
11100011111111011111
11111000011111001111
11111111F11111111111