111111111111111111111111111111111111111
100000000001100000000000001100001100001
111111111001100111111111001100001111001
111111111001101111111111100001100111001
100001100001101100000001100001100000001
100001100111101100111001111111111111001
101100001111001100111100111111111111001
101100001100001100001100001100000000001
101111111100111100001111001100111111111
101111111001111001100111101101111111111
1S1100000001100001100001101101100000001
101111111001100111111001101101111111001
100111111001100111111001101100111111101
100000000001100001100001101100000001101
111111111111111111100111101111111001101
111111111111111111001111000111111100001
100000000000001100001100000001101100001
111000111111001100111111111001101111001
111001111111101101111111111100001111001
100001100001101101100000001100001100001
100111100001101101100111001111001100111
100111001101100001100111100111101100111
100000001101100001100001100001101100001
100111111101111111111001111001111111001
100111111001111111111101111100111111001
100001100001100000001101101100000000001
100111100001100111001101101111111111111
101111001101101111101101100111111111111
101100001101101101101101100001100000001
101100111111101101101101100001100111001
101101111111100001100001101100001111001
101101100001100001100001101100001100001
101101100001111001111111101111111100111
101100001100111100111111001111111001111
1011000011000011000011000011011000011F1
101111111111001111001100111101100111101
100111111111100111000001111000000111001
100000000001100000000001100000000000001
111111111111111111111111111111111111111